X X X X X X X X X X X X X X X X 2
X X X X X X X X X X X X X X X X
0 0 0 0 0 0 0 0 0 0 0 0 X X X X
0 0 X X X X Y X X X X 0 X X X X
0 0 Y X X X X X X X X 0 X X X X
0 Y X X X Y X X X X X 0 X X X X
0 0 X X X X X Y Y X X X X X X X
P 0 X X X X X X X 0 X X 0 0 Y E
0 Y X X X X X X X X X X X X X X
0 0 X X X X X X X X X 0 X X X X
0 0 X X X X X X X X X 0 X X X X
0 Y X X X X X X X X X 0 X X X X
0 0 X X X X X X X X X 0 X X X X
0 0 0 0 0 0 0 0 0 0 0 Y X X X X
X X X X X X X X X X 0 0 X X X X
X X X X X X X X X X X X X X X X