X X X X X X X X X X X X X X X X
X X X X X X X X X X X X X X X X
X X X X X X X 0 0 X X X X X X X
X X X X X 0 0 0 X X X X X X X X
X X X 0 0 0 X 0 X X X X X X X X
X 0 0 0 X 0 X X X X X X X X X X
0 0 X 0 X X X X X X X X X X X X
0 0 X X X X X X X X X X X X X E
P 0 Y Y Y Y Y Y Y Y Y Y Y Y Y E
0 0 Y 0 Y Y Y Y Y Y Y Y Y Y Y Y
Y 0 0 0 Y 0 Y Y Y Y Y Y Y Y Y Y
Y Y Y 0 0 0 Y 0 Y Y Y Y Y Y Y Y
Y Y Y Y Y 0 0 0 Y Y Y Y Y Y Y Y
Y Y Y Y Y Y Y 0 0 Y Y Y Y Y Y Y
Y Y Y Y Y Y Y Y Y Y Y Y Y Y Y Y
Y Y Y Y Y Y Y Y Y Y Y Y Y Y Y Y