X X X X X X X X X X X X X X X X 2
X X X X X X X X X X X X X X X X
0 0 0 X X X Y Y Y Y Y 0 0 X X X
0 0 0 X X X X X Y Y Y 0 0 X X X
0 Y 0 X X X Y Y Y Y Y 0 0 X X X
0 0 0 X X X X X Y Y Y 0 0 X X X
0 Y 0 X X X Y Y Y Y Y 0 0 X X X
P 0 0 X X X X X Y Y Y 0 0 0 0 E
0 X 0 X X X Y Y Y Y Y 0 0 X X X
0 0 0 X X X X X Y Y Y 0 0 X X X
0 X 0 X X X Y Y Y Y Y 0 0 X X X
0 0 0 X X X X X Y Y Y 0 0 X X X
0 0 0 X X X Y Y Y Y Y 0 0 X X X
0 0 0 X X X X X Y Y Y 0 0 X X X
X X X X X X X X X X X X X X X X
X X X X X X X X X X X X X X X X